#domain
hospital
#levelname
MAsimple1-Design-2
#colors
red: 0, A,B,C
green: 1,3, D,E
Purple: 2, F,G
#initial
++++++++++++++++++++++++++++
+       E     0        A   +
+ G   1           3     F  +
+ +++++++++++++++++    C   +
+     2           D    B   +
++++++++++++++++++++++++++++
#goal
++++++++++++++++++++++++++++
+            E          A  +
+  G                    F  +
+ +++++++++++++++++     C  +
+        D              B  +
++++++++++++++++++++++++++++
#end
