#domain
hospital
#levelname
MAsimple1-Design
#colors
red: 0, A,B,C
green: 1, D,E
#initial
++++++++++++++++++++++++++++
+       E     0        A   +
+     1                    +
+ +++++++++++++++++    C   +
+                 D    B   +
++++++++++++++++++++++++++++
#goal
++++++++++++++++++++++++++++
+            E          A  +
+                          +
+ +++++++++++++++++     C  +
+        D              B  +
++++++++++++++++++++++++++++
#end
