#domain
hospital
#levelname
MAsimple1-Design
#colors
red: 0,2,A,B,C
green: 1,3,D,E
#initial
++++++++++++++++++++++++++++
+       E     0   A    A   +
+     1            2       +
+ +++++++++++++++++    C   +
+              3  D    B   +
++++++++++++++++++++++++++++
#goal
++++++++++++++++++++++++++++
+            E             +
+               A     A    +
+ +++++++++++++++++     C  +
+        D              B  +
++++++++++++++++++++++++++++
#end
