#domain
hospital
#levelname
MAsimple1-Design
#colors
red: 0,2,3,A,B,C
green: 1,D,E
#initial
++++++++++++++++++++++++++++
+       E     0        A   +
+     1            2       +
+ +++++++++++++++++    C   +
+    3            D    B   +
++++++++++++++++++++++++++++
#goal
++++++++++++++++++++++++++++
+            E          A  +
+                          +
+ +++++++++++++++++     C  +
+        D              B  +
++++++++++++++++++++++++++++
#end
