#domain
hospital
#levelname
MulitiBoxInOneType
#colors
red: 0,A
green: 1,B,C
#initial
++++++++++++++++++++++++++++
+       C     0        A   +
+     1                    +
+ +++++++++++++++++    A   +
+    C            B    A   +
++++++++++++++++++++++++++++
#goal
++++++++++++++++++++++++++++
+            C          A  +
+                          +
+ +++++++++++++++++     A  +
+ C      B              A  +
++++++++++++++++++++++++++++
#end
