#domain
hospital
#levelname
test1
#colors
red: 0,A
green: 1,B
blue:2,D,E
Purple:3,C
#initial
+++++++++++++++++++++
+0A1       +3       +
++ +       +2       +
++ +                +
++ +++++++   ++++++ +
++B+           E+   +
++ +       +    +C  +
+          +    +D  +
+++++++++++++++++++++
#goal
+++++++++++++++++++++
+          +       D+
++ +       +       C+
++ +                +
++ +++++++   ++++++ +
++ +            +E  +
++B+       +    +   +
+A         +    +   +
+++++++++++++++++++++
#end